lvlnb=1
lvlscope=level1

[level1]
name="the lame one"
tile_size=20
width=10
height=3
start_position=1,1,0
type=
1,1,1,1,1,1,1,1,1,1,
4,0,0,0,0,0,0,0,0,3,
1,1,1,1,1,1,1,1,1,1
size=
1,1,1,1,1,1,1,1,1,1,
4,0,0,0,0,0,0,0,0,3,
1,1,1,1,1,1,1,1,1,1
text=
1,1,1,1,1,1,1,1,1,1,
4,0,0,0,0,0,0,0,0,3,
1,1,1,1,1,1,1,1,1,1
